##########

..#.#....#

#.#...####

#.#.#.#.##

#.#.#.#.##

#.###.#.##

#.........

#.#.#.#.##

#.#.#.#.##

##########
