##########

..#.#....#

#.#...####

#.#.#.#.##

#.#.#.#.##

#.#.#.#.##

#...#.....

#.#.#.#.##

#.#.#.#.##

##########
